У жирафа передние ноги длиннее задних	Нет
Собаки различают только белый и черный цвета	Да
Муравей живет 20 лет	Да
Самый сладкий сок деревьев у березы	Нет
Синий кит весит 200 тонн	Да
Второе название Джоконды – Мона Лиза	Да
В Антарктиде 10 рек	Нет
Самая высокая трава на Земле – бамбук	Да
Кенгуру в переводе с языка аборигенов Австралии означает «не понимаю»	Да
Самая маленькая в мире собака принадлежит к породе пекиннес	Нет
Туманным Альбионом называют Швецию	Нет
У бабочки орган вкуса находится на ногах	Да
Канарейку назвали канарейкой потому, что ее привезли с Канарских островов	Да
Парламент в США называется Думой	Нет
Страус не умеет летать	Да
У осьминога кровь зеленого цвета	Нет
Одна из стадий развития насекомых называется погремушка	Нет
Весь живой мир на Земле делится на царства	Да
У гороха плод называется боб	Да
Скрипки делают из дуба	Нет
По одной из легенд, Минск назвали в честь богатыря Менеска	Да
Индийский слон – самое крупное из современных сухопутных животных	Нет
Любимого коня Александра Македонского звали Буцефал	Да
Лучшего друга Тома Сойера звали Гекльберри Финн	Да
Любимое выражение Карлсона – «Спокойствие, только спокойствие»	Да
Карлик Нос – персонаж сказки «Волшебник Изумрудного города»	Нет
Балаболки – это народное название цветка колокольчика	Да
Сказку «Аленький цветочек» написал А.С.Пушкин	Нет
В Японии ученики на доске пишут кисточкой с цветными чернилами	Да
Авторучка была изобретена еще в Древнем Египте	Да
Если пчела ужалит кого-либо, то она погибнет	Да
На зиму пингвины улетают на север	Нет
Утром человек выше ростом, чем вечером	Да
Дельфины — это маленькие киты	Да
Рог носорога обладает магической силой	Нет
